0000000000000000000000000000000000000000
0111111111111111111111111111111111111110
0000000000000000001100000000000000000000
0111111111111111111111111111111111111110
0000000000000000001100000000000000000000
0111111111111111111111111111111111111110
0000000000000000001100000000000000000000
0111111111111111111111111111111111111110
0000000000000000001100000000000000000000
0111111111111111111111111111111111111110
0000000000000000001100000000000000000000
0111111111111111111111111111111111111110
0000000000000000001100000000000000000000
0111111111111111111111111111111111111110
0000000000000000001100000000000000000000
0111111111111111111111111111111111111110
0000000000000000001100000000000000000000
0111111111111111111111111111111111111110
0000000000000000001100000000000000000000
0111111111111111111111111111111111111110
0000000000000000001100000000000000000000
0111111111111111111111111111111111111110
0000000000000000001100000000000000000000
0111111111111111111111111111111111111110
0000000000000000001100000000000000000000
0111111111111111111111111111111111111110
0000000000000000001100000000000000000000
0111111111111111111111111111111111111110
0000000000000000001100000000000000000000
0111111111111111111111111111111111111110
0000000000000000001100000000000000000000
0111111111111111111111111111111111111110
0000000000000000001100000000000000000000
0111111111111111111111111111111111111110
0000000000000000001100000000000000000000
0111111111111111111111111111111111111110
0000000000000000001100000000000000000000
0111111111111111111111111111111111111110
0000000000000000000000000000000000000000
0000000000000000000000000000000000000000