1111100100010101000101110000001100100001
1101111010110010100000110101110011001101
1100001101010011111000010010011110011000
0010111001101111100000000000110101101110
0001000001000001011010001111000101111010
1100111100011100010111000111110101010100
1001101111111110111111111001010011011100
0100111100011011101000111001011010010011
0010001110011011010101000010000010111000
0100101011000100100111010000111001000100
0111010100111001111110011100100110000000
1011100000011101000111011011010010101111
1011100101011001000110111111010010100110
0011100100111010001110101101001101001111
1000000000000001000100111010010000000000
1011111110011010001110101101011011111001
0010001110100001010111101110011111011100
1100011011011000001001111111110001000011
1000001100101010011100101110001000101010
1011111110011000111111100000010110110100
0011100011110111111111101101101000010000
1100001100100010010000110111111101111100
0001001111110011000001111010110111001001
1001000100010001111101001101001110101110
0001011100001001111100000111111100011110
0110011010111100100010100100000001011101
1011001011101101001000000101010010110100
0110010001011010110101101001011010011111
0000010110111111110000100111010001101110
1000110111001100111001101000000000001111
0001001011100110110100010101110101001111
1010100000011111111111000001100010000010
1000111111101100110110100011111111110101
1000110000010010100110001110101000010101
1111110000001010010011010111010110000010
0000001111011110100001110100111010001010
0011110101100011100001011111101001100001
0010111011001010000101010010101010100110
1110001011111010100100101101100110000010
0111001001011101011110001000010110111011