(111111)BBBB(111111)BBBB(111111)BBBB(111111)
03333330BBBB03333330BBBB03333330BBBB03333330
0222222<1111>222222<1111>222222<1111>2222220
02222223333332222223333332222223333332222220
02222222222222222222222222222222222222222220
02222222222222222222222222222222222222222220
0222222(1221)222222(1221)222222(1221)2222220
02222220322302222220322302222220322302222220
<1)22(1>2222<1)22(1>2222<1)22(1>2222<1)22(1>
33022033222233022033222233022033222222022033
BB0220222222220220222222220220222222220220BB
BB0222222222222222222222222222222222222220BB
BB0222222222222222222222222222222222222220BB
BB0220222222220220222222220220222222220220BB
(1>22<1)2222(1>22<1)2222(1>22<1)2222(1>22<1)
03322330222203322330222203322330222203322330
0222222<1221>222222<1221>222222<1221>2222220
02222223322332222223322332222223322332222220
02222222222222222222222222222222222222222220
02222222222222222222222222222222222222222220
0222222(1221)222222(1221)222222(1221)2222220
02222220322302222220322302222220322302222220
<1)22(1>2222<1)22(1>2222<1)22(1>2222<1)22(1>
33022033222233022033222233022033222222022033
BB0220222222220220222222220220222222220220BB
BB0222222222222222222222222222222222222220BB
BB0222222222222222222222222222222222222220BB
BB0220222222220220222222220220222222220220BB
(1>22<1)2222(1>22<1)2222(1>22<1)2222(1>22<1)
03322330222203322330222203322330222203322330
0222222<1221>222222<1221>222222<1221>2222220
02222223322332222223322332222223322332222220
02222222222222222222222222222222222222222220
02222222222222222222222222222222222222222220
0222222(1221)222222(1221)222222(1221)2222220
02222220322302222220322302222220322302222220
<1)22(1>2222<1)22(1>2222<1)22(1>2222<1)22(1>
33022033222233022033222233022033222222022033
BB0220222222220220222222220220222222220220BB
BB0222222222222222222222222222222222222220BB
BB0222222222222222222222222222222222222220BB
BB0220222222220220222222220220222222220220BB
(1>22<1)2222(1>22<1)2222(1>22<1)2222(1>22<1)
03322330222203322330222203322330222203322330
0222222<1221>222222<1221>222222<1221>2222220
02222223322332222223322332222223322332222220
02222222222222222222222222222222222222222220
02222222222222222222222222222222222222222220
0222222(1221)222222(1221)222222(1221)2222220
02222220322302222220322302222220322302222220
<1)22(1>2222<1)22(1>2222<1)22(1>2222<1)22(1>
33022033222233022033222233022033222222022033
BB0220222222220220222222220220222222220220BB
BB0222222222222222222222222222222222222220BB
BB0222222222222222222222222222222222222220BB
BB0220222222220220222222220220222222220220BB
(1>22<1)2222(1>22<1)2222(1>22<1)2222(1>22<1)
03322330222203322330222203322330222203322330
0222222<1221>222222<1221>222222<1221>2222220
02222223322332222223322332222223322332222220
02222222222222222222222222222222222222222220
02222222222222222222222222222222222222222220
0222222(1111)222222(1111)222222(1111)2222220
02222220333302222220333302222220333302222220
<111111>BBBB<111111>BBBB<111111>BBBB<111111>