0111111111111111111111111111111111111110
0333333333333333333333333333333333333330
0222222222222222222222222222222222222220
0111111122222222222222222222222222222220
0333333322222222222222222222222222222220
0222222222222222222222222222222222222220
0222222222222222222222222222222222222220
0222222222222222222222222222222222222220
0222222222222222222222222222222222222220
0222222222222222222222222222222222222220
0222222222222222222222222222222222222220
0222222222222222222222222222222222222220
0222222222222222222222222222222222222220
0222222222222222222222222222222222222220
0222222222222222222222222222222222222220
0222222222222222222222222222222222222220
0222222222222222222222222222222222222220
0222222222222222222222222222222222222220
0222222222222222222222222222222222222220
0222222222222222222222222222222222222220
0222222222222222222222222222222222222220
0222222222222222222222222222222222222220
0222222222222222222222222222222222222220
0222222222222222222222222222222222222220
0222222222222222222222222222222222222220
0222222222222222222222222222222222222220
0222222222222222222222222222222222222220
0222222222222222222222222222222222222220
0222222222222222222222222222222222222220
0222222222222222222222222222222222222220
0222222222222222222222222222222222222220
0222222222222222222222222222222222222220
0222222222222222222222222222222222222220
0222222222222222222222222222222222222220
0222222222222222222222222222222222222220
0222222222222222222222222222222222222220
0222222222222222222222222222222222222220
0222222222222222222222222222222222222220
0222222222222222222222222222222222222220
0111111111111111111111111111111111111110