(111111)BBBB(111111)BBBB(111111)BBBB(111111)
03333330BBBB03333330BBBB03333330BBBB03333330
0222222<1111>222222<1111>222222<1111>2222220
02222223333332222223333332222223333332222220
02222222222222222222222222222222222222222220
02222222222222222222222222222222222222222220
0222222(D22A)222222(D22A)222222(D22A)2222220
02222220322302222220322302222220322302222220
<1)22(1>2222<1)22(1>2222<1)22(1>2222<1)22(1>
33022033222233022033222233022033222233022033
BB022S22222222S22S22222222S22S22222222S220BB
BB0223222222223223222222223223222222223220BB
BB0222222222222222222222222222222222222220BB
BB0222222222222222222222222222222222222220BB
BB022W22222222W22W22222222W22W22222222W220BB
(1>22<1)2222(1>22<1)2222(1>22<1)2222(1>22<1)
03322330222203322330222203322330222203322330
0222222<D22A>222222<D22A>222222<D22A>2222220
02222223322332222223322332222223322332222220
02222222222222222222222222222222222222222220
02222222222222222222222222222222222222222220
0222222(D22A)222222(D22A)222222(D22A)2222220
02222220322302222220322302222220322302222220
<1)22(1>2222<1)22(1>2222<1)22(1>2222<1)22(1>
33022033222233022033222233022033222233022033
BB022S22222222S22S22222222S22S22222222S220BB
BB0223222222223223222222223223222222223220BB
BB0222222222222222222222222222222222222220BB
BB0222222222222222222222222222222222222220BB
BB022W22222222W22W22222222W22W22222222W220BB
(1>22<1)2222(1>22<1)2222(1>22<1)2222(1>22<1)
03322330222203322330222203322330222203322330
0222222<D22A>222222<D22A>222222<D22A>2222220
02222223322332222223322332222223322332222220
02222222222222222222222222222222222222222220
02222222222222222222222222222222222222222220
0222222(D22A)222222(D22A)222222(D22A)2222220
02222220322302222220322302222220322302222220
<1)22(1>2222<1)22(1>2222<1)22(1>2222<1)22(1>
33022033222233022033222233022033222233022033
BB022S22222222S22S22222222S22S22222222S220BB
BB0223222222223223222222223223222222223220BB
BB0222222222222222222222222222222222222220BB
BB0222222222222222222222222222222222222220BB
BB022W22222222W22W22222222W22W22222222W220BB
(1>22<1)2222(1>22<1)2222(1>22<1)2222(1>22<1)
03322330222203322330222203322330222203322330
0222222<D22A>222222<D22A>222222<D22A>2222220
02222223322332222223322332222223322332222220
02222222222222222222222222222222222222222220
02222222222222222222222222222222222222222220
0222222(D22A)222222(D22A)222222(D22A)2222220
02222220322302222220322302222220322302222220
<1)22(1>2222<1)22(1>2222<1)22(1>2222<1)22(1>
33022033222233022033222233022033222233022033
BB022S22222222S22S22222222S22S22222222S220BB
BB0223222222223223222222223223222222223220BB
BB0222222222222222222222222222222222222220BB
BB0222222222222222222222222222222222222220BB
BB022W22222222W22W22222222W22W22222222W220BB
(1>22<1)2222(1>22<1)2222(1>22<1)2222(1>22<1)
03322330222203322330222203322330222203322330
0222222<D22A>222222<D22A>222222<D22A>2222220
02222223322332222223322332222223322332222220
02222222222222222222222222222222222222222220
02222222222222222222222222222222222222222220
0222222(1111)222222(1111)222222(1111)2222220
02222220333302222220333302222220333302222220
<111111>BBBB<111111>BBBB<111111>BBBB<111111>
33333333BBBB33333333BBBB33333333BBBB33333333